
{
  "Niveau 1": {
    "nbNiveau": 1 ,
    "nbMonstre": 0,
    "matrice": [
      ["w","w","w","w","w","w","w","w","w","w","w","w"],
      ["i"," "," "," "," "," ","_","_","w","w","w","w"],
      ["w","w","w","w","w"," ","w","_","w","_","w","w"],
      ["w","w","_","_","w"," ","w","_","_","_","_","w"],
      ["w","w","_","w","w"," ","w","w","_","w","w","w"],
      ["w","w"," "," "," "," ","_","w","_","w","w","w"],
      ["w","_"," ","w","w","w","w","w"," "," "," ","w"],
      ["w","w"," ","w","_","w","w","w"," ","w"," ","w"],
      ["w","_"," "," "," "," "," "," "," ","w"," ","w"],
      ["w","_","w","w","w","_","w","w","w","w"," ","w"],
      ["w","_","w","w","w","w","_","_","_","_"," ","s"],
      ["w","w","w","w","w","w","w","w","w","w","w","w"]
    ]
  },

  "Niveau 2": {
    "nbNiveau": 2 ,
    "nbMonstre": 5,
    "matrice": [
      ["i"," ","w","w","w","w","w","w","w","w","w","w","w","w","w","w","w","w","w","w","w","w","w","w"],
      ["w"," ","w","w"," ","_","w","w"," "," "," "," "," "," "," "," "," "," "," "," "," "," "," ","w"],
      ["w"," ","w","w","w","_","w","w"," ","w","w","w","w","w","w","w","w","w","w","w","w","w"," ","w"],
      ["w"," ","w","w","w"," ","w","w"," ","w"," "," "," "," "," "," "," "," "," "," ","w","w"," ","w"],
      ["w"," "," "," "," "," "," "," "," ","w"," ","w","w","w","w","w"," ","w","w","w","w","w"," ","w"],
      ["w"," ","w"," ","w","w","w"," ","w","w"," ","w","w"," ","w","w"," ","w","w","w","w","w"," ","w"],
      ["w","_","w"," "," "," ","w"," ","w","w"," ","w","w"," "," "," "," ","w","w","w","w","w","L","w"],
      ["w","_","w"," "," "," "," "," "," ","w"," ","w","w","w","w","w"," ","w","w","w","w","w","w","w"],
      ["w","_","w"," ","w","w"," ","w","w","w"," ","w"," "," "," "," "," ","w","w","w","w","w","w","w"],
      ["w","_","w"," ","w","w"," "," "," ","w"," ","w"," ","w","w","w"," ","w"," "," "," "," "," "," "],
      ["w","w","w"," ","w","w","w","w","w","w"," ","w"," ","w","w","w"," ","w"," ","_","_","_","_"," "],
      ["w","w","w"," "," "," "," "," "," "," "," ","w"," ","w","_"," "," ","w"," "," "," ","w","w"," "],
      ["w"," ","w","w","w","w","w","w","w","w"," ","w"," ","w","_","w"," ","w","w","w"," ","w","w"," "],
      ["w"," ","w","w","w","w","w","w","w","w"," ","w","w","w","_","w"," ","w","w","w"," ","w"," "," "],
      ["w"," "," "," "," "," "," "," "," "," "," "," "," "," "," "," "," ","w","w","w"," ","w"," ","w"],
      ["w","w"," ","w","w","w","w","w","w","w","w","w","w","w","w","w","w","w","w","w"," ","w"," ","w"],
      [" "," "," "," "," "," "," "," "," "," "," "," "," "," "," "," "," "," "," ","_"," ","w"," ","w"],
      ["w","w"," ","w","w","w","w","w","w","w","w","w"," ","_"," ","w","w","w"," ","_"," ","w"," ","w"],
      ["_","w"," ","w","w","w","w","_","w","w"," "," "," ","_"," ","w"," "," "," ","_"," ","w"," ","w"],
      ["_","w"," ","w","w","_","_","_"," "," "," ","w","w","w"," ","w"," ","_","_","_"," ","w"," ","w"],
      ["_","w","w","w","w","w"," "," "," ","w","w","w","w"," "," ","w"," "," "," "," "," ","w"," ","w"],
      [" "," "," "," "," "," "," ","w","w","w","w"," "," "," ","w","w","w","w","w","w","w","w"," ","w"],
      [" ","w","w","w","w","w","w","w","w"," "," "," ","w","w","w","w","w","w","s"," "," "," "," ","w"],
      [" "," "," "," "," "," "," "," "," "," ","w","w","w","w","w","w","w","w","w","w","w","w","w","w"]
    ]
  },

  "Niveau 3": {
    "nbNiveau": 3 ,
    "nbMonstre": 5,
    "matrice": [
      ["w","w","w","w","w","w","w","w","w","w","w","w","w","w","w","w","w","w","w","w","w","w","w","w","w","w","w","w","w","w","w","w","w","w","w","w"],
      ["i"," "," "," "," "," "," ","w","w","w","w","w","w","w","w","w","w","w","w","w","w","w","_","w","w","w","w","w","w","w","w","_","w","w","w","w"],
      ["w","w","w","w","w","w"," ","w","w","w","w","w","w","w","w","w","w","w","w","w","w","w","_","w","w","w","w","_","w","w","w","_","w","w","w","w"],
      ["w","w","w","w","w","w"," ","w","w","w","w","w","w"," "," "," "," ","_","_","_","_","_","_","_","_","_","_","_","_","_","_","_","_","_","_","_"],
      ["w","w","_","w","w","w"," ","w","w","w","w","w","w"," ","w","w"," ","w","w","w","w","w","_","w","w","w","w","_","w","w","w","w","w","w","w","w"],
      ["w","w","_","_","_","_"," "," "," "," "," "," "," "," ","w","w"," ","w","w","w","w","w","_","w","w","w","w","_","w","_","_","_","_","w","w","w"],
      ["w","w","_","w","w","w","w","w","w","w","w","w","w","w","w","w"," ","w","w","w","w","w","w","w","w","w","w","_","w","w","_","w","w","w","w","w"],
      ["w","w","_","w","w","w","w","w","w","w","w"," "," "," "," "," "," ","w","w"," "," "," "," "," "," ","w","w","_","w","w","_","w","w","w","w","w"],
      ["w","w","_","_","_","_","_","_","_","_","w"," ","w","w","w","w","w","_","w"," ","w","w","w","w"," ","w","w","_","_","_","_","w","w","w","w","w"],
      ["w","w","w","w","w","_","w","w","w","_","w"," ","_","_","_","_","_","_","w"," "," "," "," ","w"," ","w","w","w","w","w","_","w","w","w","w","w"],
      ["w","w","w","w","w","_","w","w","w","_","w"," ","w","w","w","w","w","_","w","w","w","w"," ","w"," ","w","w","w","w","w","_","w","_","_","_","w"],
      ["w","w","w","w","w","w","w","w","w","w","w"," ","w","w","w","w","w","w","w","w","w","w"," ","w"," ","_","_","_","_","_","_","w","w","w","_","w"],
      ["w","w","w"," "," "," "," "," ","w","w","w"," "," "," "," "," "," "," "," "," "," "," "," ","w"," ","w","w","w","w","w","_","w","w","w","_","w"],
      ["w","w","w"," ","w","w","w"," ","w","_","_","w","w","w","w","_","w","w","w","w","w","w","w","w"," ","w","w","w","w","w","_","w","w","w","_","w"],
      ["w","w","w"," ","_","_","w"," ","w","w","_","w","w","w","w","_","w","w","w","w","w","w","w","w"," ","w","w","w","w","w","w","w","w","w","_","w"],
      ["w","w","w"," ","w","w","w"," ","w","w","_","w","w","w","w","_","_","_","_","_","_","_","_","_"," ","w","w","w","w"," "," "," "," ","_","_","w"],
      ["w","w","w"," "," "," ","w"," ","w","w"," "," "," "," ","w","w","w","w","_","w","w","_","w","w"," ","w","w","w","w"," ","w","w"," ","w","w","w"],
      ["w","w","w","w","w"," ","w"," ","w","w"," ","w","w"," ","w","w","w","w","_","w","w","_","w","w"," ","w","w","w","w"," ","w","w"," ","w","w","w"],
      ["w","w","w","w","w"," ","w"," ","w","w"," ","w","w"," ","w","w","w","w","_","w","w","w","w","w"," ","w","w"," "," "," ","w","w"," ","w","w","w"],
      ["w","w"," "," "," "," ","w"," ","w","w"," ","w","w"," ","w","w","w","w","_","w","w","w","w","w"," ","w","w"," ","w","w","w","w"," ","w","w","w"],
      ["w","w"," ","w","w","w","w"," ","w","w"," ","w","w"," "," "," "," "," "," "," "," "," "," "," "," ","w","w"," ","w","w","w","w"," ","_","_"," "],
      ["w","w"," ","w","_","w","w"," ","w","w"," ","w","w","w","w","w","w","w","w","w","w","w","w","w","w","w","w"," ","w","_","_","w"," ","w","w","w"],
      ["w","w"," ","_","_","_","_"," ","w","w"," "," "," "," "," "," "," ","_","_","_","_","_","_","w","w","w","w"," ","w","w","_","w"," ","w","w","w"],
      ["w","w"," ","w","_","w","w"," ","w","w","w","w","_","w","w","w"," ","w","w","w","w","_","w","w"," "," "," "," ","w","w","_","w"," ","w","w","w"],
      ["w","w"," ","w","_","w","w"," ","_","_","_","_","_","_","_","w"," "," "," "," ","w","_","w","w"," ","w","_","w","w","w","_","w"," ","w","w","w"],
      ["w","w"," ","w","_","w","w"," ","w","w","w","w","w","w","_","w","w","w","w"," ","w","_","w","w"," ","w","_","_","_","_","_","w"," ","w","w","w"],
      ["w","w"," "," "," "," ","w"," ","w","w","w","w","w","w","_","w","w","w","w"," ","_","_","_","_"," ","w","_","w","w","w","_","w"," ","w","w","w"],
      ["w","w","w","_","w"," ","w"," "," "," "," "," "," "," "," "," "," "," "," "," ","w","w","w","w"," ","w","_","w","w","w","w","w"," ","w","w","w"],
      ["w","w","w","_","w"," ","w","_","w","w","w","w","w","w","w","w","w","w","w","w","w","w","w","w"," ","w","_","w"," "," "," "," "," ","w","w","w"],
      ["w","w","w","_","w"," ","w","_","_","_","_","_","_","_","_","_","_","w","w","w","w","w","w","w"," ","w","_","w"," ","w","w","_","w","w","w","w"],
      ["w","w","w","_","w"," ","w","_","w","w","w","w","w","w","w","w","_","w","w","w","w","w","w","w"," ","w","_","w"," ","w","w","_","_","_","w","w"],
      ["w","_","w","_","w"," "," "," "," "," "," "," "," "," "," "," "," "," "," "," "," "," "," "," "," ","w","_","w"," ","w","w","w","w","w","w","w"],
      ["w","_","w","_","w","w","w","w","w","w","_","w","w","w","w","w","w","w","w","_","w","w","w","w","w","w","_","w"," "," "," "," "," "," "," ","s"],
      ["w","_","_","_","_","_","_","_","_","_","_","w","w","w","w","w","w","w","w","_","_","_","_","_","_","_","_","w","w","w","w","w","w","w","w","w"],
      ["w","w","w","w","w","w","w","w","w","w","_","w","w","w","w","w","w","w","w","w","w","w","_","w","w","w","w","w","w","w","w","w","w","w","w","w"],
      ["w","w","w","w","w","w","w","w","w","w","w","w","w","w","w","w","w","w","w","w","w","w","w","w","w","w","w","w","w","w","w","w","w","w","w","w"]
    ]
  },

  "Niveau 6": {
    "nbNiveau": 6 ,
    "nbMonstre": 20,
    "matrice": [
      ["w","w","w","w","w","w","w","w","w","w","w","w","w","w","w","w","w","w","w","w","w","w","w","w","w","w","w","w","w","w","w","w","w","w","w","w","w","w","w","w","w","w","w","w","w","w","w","w","w","w","w","w","w","w","w","w","w","w","w","w","w","w"],
      ["i"," "," "," ","_","_","_","_","_","_","_","_","w","_","_","_","w","_","_","_","_","_","_","_","_","_","w","_","_","_","_","_","w","_","_","_","_","_","_","_","_","_","_","_","_","_","w","_","_","_","w","_","_","_","w","_","_","_","_","_","_","w"],
      ["w","_","w"," ","w","w","w","_","w","w","w","_","w","_","w","_","w","_","w","w","w","w","w","w","w","_","w","_","w","_","w","_","w","w","w","_","w","w","w","_","w","w","w","w","w","_","w","w","w","_","w","_","w","w","w","_","w","w","w","w","w","w"],
      ["w","_","w"," "," "," ","w","_","w","_","_","_","w","_","w","_","w","_","w","_","_","_","_","_","w","_","w","_","w","_","w","_","_","_","_","_","_","_","w","_","_","_","_","_","w","_","_","_","_","_","w","_","_","_","_","_","_","_","_","_","_","w"],
      ["w","_","w","w","w"," ","w","_","w","_","w","w","w","_","w","w","w","_","w","_","w","w","w","w","w","_","w","w","w","_","w","w","w","w","w","w","w","w","w","w","w","w","w","_","w","w","w","w","w","w","w","_","w","w","w","w","w","w","w","_","_","w"],
      ["w","_","_","_","w"," ","w","_","w","_","_","_","w","_","w","_","_","_","w","_","w","_","_","_","w","_","_","_","w","_","w","_","_","_","_","_","_","_","_","_","_","_","w","_","_","_","w","_","_","_","_","_","w","_","_","_","_","_","w","_","_","w"],
      ["w","w","w","_","w"," ","w","w","w","w","w","_","w","_","w","_","w","w","w","_","w","_","w","_","w","w","w","_","w","_","w","_","w","_","w","w","w","w","w","_","w","_","w","w","w","_","w","_","w","w","w","w","w","_","w","w","w","w","w","_","_","w"],
      ["w","_","_","_","w"," "," "," ","w","_","_","_","w","_","w","_","w","_","_","_","w","_","w","_","w","_","_","_","w","_","w","_","w","_","_","_","_","_","w","_","w","_","_","_","_","_","w","_","_","_","_","_","w","_","_","_","_","_","_","_","_","w"],
      ["w","_","w","_","w","w","w"," ","w","w","w","w","w","_","w","_","w","_","w","w","w","_","w","w","w","_","w","w","w","_","w","w","w","w","w","w","w","_","w","w","w","w","w","_","w","_","w","w","w","w","w","w","w","_","w","w","w","w","w","w","w","w"],
      ["w","_","w","_","w","_","w"," "," "," "," "," "," "," ","w","_","w","_","_","_","w","_","w","_","_","_","w","_","_","_","w","_","_","_","_","_","w","_","_","_","w","_","w","_","w","_","_","_","_","_","_","_","_","_","w","_","_","_","_","w","_","w"],
      ["w","_","w","_","w","_","w","_","w","w","w","w","w"," ","w","_","w","w","w","_","w","_","w","_","w","w","w","w","w","w","w","_","w","w","w","_","w","w","w","_","w","_","w","_","w","w","w","w","w","_","w","w","w","w","w","_","w","w","_","w","_","w"],
      ["w","_","w","_","_","_","w","_","w","_","_","_","w"," ","w","_","w","_","_","_","w","_","w","_","w","_","_","_","_","_","_","_","w","_","_","_","w","_","_","_","_","_","w","_","_","_","_","_","w","_","_","_","_","_","_","_","w","w","_","_","_","w"],
      ["w","w","w","w","w","w","w","_","w","_","w","w","w"," ","w","_","w","_","w","_","w","_","w","_","w","_","w","w","w","w","w","w","w","w","w","w","w","w","w","w","w","w","w","w","w","w","w","_","w","w","w","w","w","w","w","w","w","w","w","w","_","w"],
      ["w","_","_","_","w","_","_","_","w","_","_","_","w"," ","w","_","w","_","w","_","w","_","w","_","w","_","_","_","w","_","_","_","_","_","_","_","w","_","_","_","w","_","_","_","_","_","_","_","w","_","_","_","_","_","_","w","_","_","_","w","_","w"],
      ["w","_","w","_","w","w","w","w","w","w","w","_","w"," ","w","_","w","_","w","_","w","_","w","_","w","_","w","_","w","_","w","w","w","_","w","w","w","_","w","_","w","_","w","w","w","_","w","w","w","_","_","w","w","w","_","w","_","w","_","w","_","w"],
      ["w","_","w","_","_","_","w","_","_","_","_","_","w"," ","w","_","w","_","w","_","w","_","_","_","w","_","w","_","w","_","w","_","_","_","_","_","_","_","w","_","w","_","_","_","w","_","w","_","_","_","_","w","_","_","_","w","_","w","_","w","_","w"],
      ["w","_","w","w","w","_","w","_","w","w","w","w","w"," ","w","_","w","_","w","_","w","w","w","w","w","_","w","_","w","_","w","_","w","w","w","w","w","w","w","_","w","w","w","_","w","w","w","_","w","w","w","w","w","w","_","w","_","w","_","w","w","w"],
      ["w","_","w","_","_","_","_","_","w","_","_","_","w"," ","w","_","w","_","w","_","w","_","_","_","_","_","w","_","w","_","w","_","_","_","_","_","_","_","w","_","w","_","_","_","_","_","_","_","w","_","_","_","_","_","_","_","_","w","_","_","_","w"],
      ["w","w","w","_","w","w","w","w","w","_","w","_","w"," ","w","_","w","_","w","_","w","_","w","w","w","w","w","_","w","_","w","w","w","w","w","w","w","_","w","w","w","_","w","w","w","w","w","w","w","w","_","w","w","w","w","w","w","w","w","w","_","w"],
      ["w","_","_","_","w","_","_","_","_","_","w","_","w"," "," "," ","w","_","w","_","w","_","w","_","_","_","_","_","w","_","_","_","w","_","_","_","w","_","_","_","w","_","_","_","w","_","_","_","_","_","_","w","_","_","_","w","_","_","_","_","_","w"],
      ["w","_","w","w","w","_","w","w","w","w","w","_","w","w","w"," ","w","w","w","_","w","w","w","_","w","w","w","w","w","w","w","_","w","_","w","w","w","_","w","_","w","_","w","_","w","_","w","w","w","w","w","w","_","w","_","w","_","w","w","w","w","w"],
      ["w","_","w","_","_","_","w","_","_","_","_","_","_","_","w"," ","w","_","_","_","w","_","_","_","w","_","_","_","_","_","w","_","w","_","_","_","w","_","w","_","_","_","w","_","w","_","w","w","_","_","_","w","_","w","_","_","_","_","_","_","_","w"],
      ["w","_","w","_","w","w","w","_","w","w","w","w","w","w","w"," ","w","_","w","_","w","_","w","w","w","_","w","_","w","_","w","_","w","_","w","_","w","w","w","w","w","_","w","w","w","_","w","w","_","w","w","w","w","w","w","w","w","w","w","w","_","w"],
      ["w","_","_","_","w","_","_","_","w","_","w"," "," "," "," "," ","w","_","w","_","_","_","w","_","_","_","w","_","w","_","_","_","_","_","w","_","w","_","_","_","w","_","w","_","_","_","_","_","_","_","_","_","_","_","_","w","_","_","_","_","_","w"],
      ["w","w","w","w","w","_","w","w","w","_","w"," ","w","w","w","w","w","_","w","w","w","w","w","_","w","w","w","w","w","w","w","w","w","w","w","_","w","_","w","_","w","_","w","_","w","w","w","w","w","w","w","w","w","w","_","w","w","w","_","w","_","w"],
      ["w","_","_","_","_","_","_","_","_","_","w"," ","w","_","_","_","w","_","w","_","_","_","_","_","w","_","_","_","w","_","_","_","_","_","_","_","w","_","w","_","w","_","w","_","_","_","_","_","_","_","w","_","_","_","_","_","w","w","_","w","_","w"],
      ["w","_","w","w","w","w","w","w","w","w","w"," ","w","_","w","w","w","_","w","_","w","w","w","_","w","_","w","_","w","_","w","w","w","w","w","w","w","_","w","_","w","_","w","w","w","_","w","w","w","_","w","w","w","w","w","_","w","w","w","w","_","w"],
      ["w","_","_","_","_"," "," "," "," "," ","w"," ","w","_","w","_","_","_","w","_","w","_","_","_","w","_","w","_","w","_","_","_","w","_","w","_","_","_","w","_","w","_","_","_","_","_","w","_","_","_","_","_","_","_","_","_","w","w","_","_","_","w"],
      ["w","w","w","w","w"," ","w","w","w"," ","w"," ","w","_","w","_","w","w","w","_","w","_","w","w","w","_","w","w","w","w","w","_","w","_","w","_","w","w","w","_","w","_","w","w","w","_","w","w","w","w","w","w","w","w","w","_","w","w","_","w","_","w"],
      ["w","_","_"," "," "," ","w","_","_"," "," "," ","w","_","w","_","_","_","_","_","w","_","_","_","_","_","w","_","_","_","_","_","w","_","_","_","w","_","_","_","w","_","w","_","_","_","_","_","_","_","w","_","_","_","w","_","w","w","_","w","_","w"],
      ["w","_","w"," ","w","w","w","w","w","_","w","w","w","_","w","w","w","w","w","w","w","w","w","w","w","w","w","_","w","w","w","w","w","w","w","w","w","w","w","_","w","_","w","_","w","w","w","w","w","_","w","_","w","_","w","_","w","w","_","w","_","w"],
      ["w","_","w"," ","w","_","_","_","_","_","_","_","w","_","_","_","w","_","_","_","_","_","_","_","_","_","_","_","w","_","_","_","_","_","w","_","_","_","w","_","w","_","w","_","_","_","w","_","_","_","w","_","w","_","w","_","w","w","_","w","_","w"],
      ["w","_","w"," ","w","w","w","w","w","w","w","_","w","w","w","_","w","_","w","w","w","w","w","w","w","w","w","w","w","_","w","w","w","_","w","_","w","_","w","_","w","_","w","w","w","_","w","_","w","w","w","_","w","w","w","_","w","w","_","w","_","w"],
      ["w","w","w"," "," "," ","w","_","_","_","w","_","_","_","w","_","w","_","_","_","_","_","_","_","_","_","w","_","_","_","w","_","_","_","w","_","w","_","w","_","_","_","_","_","w","_","w","_","_","_","w","_","w","_","_","_","w","w","_","w","_","w"],
      ["w","w","w","w","w"," ","w","_","w","_","w","w","w","_","w","_","w","_","w","w","w","w","w","_","w","w","w","_","w","w","w","_","w","w","w","_","w","_","w","w","w","w","w","_","w","_","w","w","w","_","w","_","w","_","w","w","w","w","w","w","_","w"],
      ["w"," "," "," "," "," ","w","_","w","_","_","_","_","_","_","_","w","_","w"," "," "," ","w","_","_","_","_","_","w","_","_","_","w","_","_","_","w","_","w","_","_","_","_","_","w","_","_","_","w","_","w","_","_","_","w","_","w","w","_","_","_","w"],
      ["w"," ","w","w","w","w","w","w","w","w","w","w","w","w","w","w","w","w","w"," ","w"," ","w","w","w","w","w","w","w","_","w","w","w","_","w","w","w","w","w","_","w","w","w","w","w","w","w","_","w","_","w","w","w","w","w","_","w","w","_","_","_","w"],
      ["w"," "," "," ","w","_","_","_","_","_","w","_","_","_","_","_","w"," "," "," ","w"," "," "," ","w","_","_","_","_","_","_","_","w","_","w","_","_","_","_","_","w","_","w","_","_","_","w","_","w","_","_","_","_","_","w","_","w","w","_","_","_","w"],
      ["w","w","w"," ","w","_","w","w","w","_","w","w","w","w","w","_","w"," ","w","w","w","w","w"," ","w","w","w","w","w","w","w","w","w","_","w","w","w","_","w","w","w","_","w","_","w","_","w","_","w","w","w","w","w","_","w","_","w","w","w","w","_","w"],
      ["w","_","w"," ","w","_","_","_","w","_","w"," "," "," "," "," "," "," ","w","_","_","_","_"," "," "," "," "," ","w","_","w","_","_","_","w","_","_","_","w","_","w","_","_","_","w","_","_","_","_","_","_","_","w","_","w","_","_","_","_","w","_","w"],
      ["w","_","w"," ","w","w","w","w","w","_","w"," ","w","w","w","w","w","w","w","_","w","w","w","w","w","w","w"," ","w","_","w","_","w","_","w","_","w","w","w","_","w","_","w","w","w","w","w","w","w","w","w","w","w","_","w","w","w","w","_","w","_","w"],
      ["w","_","w"," "," "," "," "," "," "," ","w"," "," "," ","w","_","w","_","_","_","w"," "," "," "," "," "," "," ","w","_","_","_","w","_","_","_","w","_","_","_","w","_","w","_","_","_","_","_","_","_","w","_","_","_","w","_","w","w","_","w","_","w"],
      ["w","_","w","w","w","w","w","w","w"," ","w","w","w"," ","w","_","w","_","w","w","w"," ","w","w","w","w","w","w","w","w","w","w","w","w","w","w","w","_","w","w","w","_","w","_","w","w","w","w","w","_","w","_","w","w","w","_","w","w","_","w","_","w"],
      ["w","_","_","_","_","_","w","_","w"," ","w"," "," "," ","w","_","w","_","_","_","w"," "," "," "," "," "," "," ","_","_","_","_","w","_","_","_","w","_","_","_","w","_","w","_","w","_","_","_","w","_","_","_","w","_","_","_","w","w","_","w","_","w"],
      ["w","w","w","_","w","_","w","_","w"," ","w"," ","w","w","w","_","w","w","w","_","w","w","w","w","w","w","w"," ","w","w","w","w","w","_","w","_","w","_","_","_","w","_","w","_","w","_","w","_","w","w","w","_","w","_","w","_","w","w","_","w","w","w"],
      ["w","_","_","_","w","_","_"," "," "," ","w"," ","_","_","w","_","_","_","_","_","w","_","_","_","_","_","w"," ","w","_","_","_","w","_","w","_","_","_","_","_","_","_","w","_","_","_","w","_","_","_","w","_","w","_","w","_","_","_","_","_","w","w"],
      ["w","w","w","w","w","w","w"," ","w","w","w"," ","w","_","w","_","w","w","w","w","w","_","w","w","w","_","w"," ","w","_","w","_","w","_","w","w","w","w","w","w","w","w","w","w","w","w","w","w","w","_","w","_","w","w","w","w","w","w","w","_","w","w"],
      ["w","_","_","_","_","_","w"," "," "," "," "," ","w","_","w","_","_","_","w","_","_","_","w","_","w","_","w"," ","w","_","w","_","w","_","w","_","_","_","_","_","w","_","_","_","_","_","_","_","w","_","w","_","_","_","_","_","_","_","w","_","w","w"],
      ["w","_","w","w","w","_","w","w","w","w","w","_","w","_","w","w","w","w","w","_","w","w","w","_","w","_","w"," ","w","_","w","_","w","w","w","_","w","_","w","_","w","w","w","w","w","w","w","_","w","w","w","w","w","_","w","w","w","_","w","_","w","w"],
      ["w","_","w","_","w","_","_","_","_","_","_","_","w","_","_","_","w","_","_","_","w","_","_","_","w","_","w"," ","_","_","w","_","_","_","w","_","w","_","w","_","_","_","_","_","_","_","w","_","_","_","_","_","_","_","w","_","w","_","_","_","w","w"],
      ["w","_","w","_","w","w","w","w","w","w","w","w","w","w","w","_","w","_","w","w","w","_","w","w","w","_","w"," ","w","w","w","w","w","_","w","_","w","w","w","w","w","_","w","w","w","w","w","_","w","_","w","w","w","_","w","_","w","w","w","_","w","w"],
      ["w","_","_","_","w","_","_","_","_","_","_","_","_","_","_","_","w","_","w","_","_","_","w"," "," "," "," "," ","w","_","_","_","_","_","w","_","w"," "," "," ","w","_","_","_","_","_","w","_","w","_","w","_","_","_","w","_","_","_","_","_","w","w"],
      ["w","w","w","w","w","_","w","w","w","w","w","_","w","w","w","w","w","_","w","_","w","w","w"," ","w","w","w","w","w","_","w","w","w","w","w","w","w"," ","w"," ","w","w","w","w","w","_","w","w","w","_","w","w","w","w","w","w","w","w","w","w","w","w"],
      ["w","_","_","_","w","_","_","_","w","_","w","_","w","_","_","_","w","_","_","_","w","_","_"," "," "," "," "," ","w","_","w"," "," "," "," "," "," "," ","w"," "," "," ","w","_","w","_","_","_","w","_","_","_","w","_","_","_","_","_","_","_","w","w"],
      ["w","_","w","w","w","w","w","_","w","_","w","_","w","_","w","_","w","w","w","w","w","_","w","w","w","w","w"," ","w","_","w"," ","w","w","w","w","w","w","w","w","w"," ","w","_","w","w","w","_","w","w","w","_","w","_","w","w","w","w","w","_","w","w"],
      ["w","_","_","_","_","_","w","_","_","_","w","_","_","_","w","_","_","_","w","_","w","_","w","_","_","_","w"," ","w","_","w"," ","w","_","_","_","_","_","w","_","_"," ","w","_","_","_","_","_","_","_","w","_","w","_","_","_","_","_","w","_","w","w"],
      ["w","_","w","w","w","w","w","w","w","w","w","w","w","w","w","w","w","_","w","_","w","_","w","_","w","_","w"," ","w","w","w"," ","w","_","w","w","w","_","w","w","w"," ","w","w","w","w","w","w","w","_","w","_","w","_","w","_","w","_","w","w","w","w"],
      ["w","_","_","_","_","_","w","_","w","_","_","_","w","_","_","_","_","_","_","_","w","_","_","_","w","_","w"," "," "," "," "," ","w","_","_","_","w","_","w","_","w"," "," "," "," "," "," "," ","_","_","w","_","_","_","w","_","w"," "," "," ","w","w"],
      ["w","w","w","_","w","_","w","_","w","_","w","_","w","_","w","w","w","w","w","w","w","w","w","w","w","_","w","w","w","w","w","w","w","w","w","w","w","_","w","_","w","w","w","w","w","_","w"," ","w","w","w","w","w","w","w","w","w"," ","_"," ","w","w"],
      ["w","_","_","_","w","_","_","_","_","_","w","_","_","_","_","_","_","_","_","_","_","_","_","_","w","_","_","_","_","_","_","_","_","_","_","_","_","_","w","_","_","_","_","_","_","_","w"," "," "," "," "," "," "," "," "," "," "," ","_"," "," ","s"],
      ["w","w","w","w","w","w","w","w","w","w","w","w","w","w","w","w","w","w","w","w","w","w","w","w","w","w","w","w","w","w","w","w","w","w","w","w","w","w","w","w","w","w","w","w","w","w","w","w","w","w","w","w","w","w","w","w","w","w","w","w","w","w"]
    ]
  }
}

