{
  "Niveau 1": {
    "nbNiveau": 1 ,
    "nbMonstre": 0,
    "matrice": [
      ["w","w","w","w","w","w","w","w","w","w","w","w"],
      ["i"," "," "," "," "," ","_","_","w","w","w","w"],
      ["w","w","w","w","w"," ","w","_","w","_","w","w"],
      ["w","w","_","_","w"," ","w","_","_","_","_","w"],
      ["w","w","_","w","w"," ","w","w","_","w","w","w"],
      ["w","w"," "," "," "," ","_","w","_","w","w","w"],
      ["w","_"," ","w","w","w","w","w"," "," "," ","w"],
      ["w","w"," ","w","_","w","w","w"," ","w"," ","w"],
      ["w","_"," "," "," "," "," "," "," ","w"," ","w"],
      ["w","_","w","w","w","_","w","w","w","w"," ","w"],
      ["w","_","w","w","w","w","_","_","_","_"," ","s"],
      ["w","w","w","w","w","w","w","w","w","w","w","w"],
    ]
  }
}
